"filename", "language", "Python", "comment", "blank", "total"
"/home/hhy/Social-Production/CCMABM.py", "Python", 710, 123, 176, 1009
"/home/hhy/Social-Production/CartPoleContinuous.py", "Python", 49, 7, 8, 64
"/home/hhy/Social-Production/DSO.py", "Python", 174, 16, 30, 220
"/home/hhy/Social-Production/DSO_Gym.py", "Python", 211, 18, 42, 271
"/home/hhy/Social-Production/DSO_SP.py", "Python", 137, 7, 24, 168
"/home/hhy/Social-Production/DoubleAuction.py", "Python", 73, 17, 14, 104
"/home/hhy/Social-Production/Gumbel.py", "Python", 146, 11, 42, 199
"/home/hhy/Social-Production/VPG_SP.py", "Python", 99, 12, 25, 136
"/home/hhy/Social-Production/agent.py", "Python", 319, 38, 74, 431
"/home/hhy/Social-Production/algorithms/PPO.py", "Python", 206, 25, 53, 284
"/home/hhy/Social-Production/configuration.py", "Python", 126, 16, 20, 162
"/home/hhy/Social-Production/env.py", "Python", 563, 109, 146, 818
"/home/hhy/Social-Production/examples/PolicyGradient.py", "Python", 84, 4, 24, 112
"/home/hhy/Social-Production/examples/atari.py", "Python", 87, 5, 12, 104
"/home/hhy/Social-Production/examples/classification.py", "Python", 92, 20, 24, 136
"/home/hhy/Social-Production/examples/reg_test.py", "Python", 59, 7, 18, 84
"/home/hhy/Social-Production/examples/test_atari.py", "Python", 21, 0, 5, 26
"/home/hhy/Social-Production/function.py", "Python", 136, 45, 36, 217
"/home/hhy/Social-Production/multi_run.py", "Python", 62, 5, 12, 79
"/home/hhy/Social-Production/multi_search.py", "Python", 89, 33, 17, 139
"/home/hhy/Social-Production/run.py", "Python", 46, 1, 7, 54
"/home/hhy/Social-Production/single_test.py", "Python", 69, 8, 8, 85
"/home/hhy/Social-Production/solve.py", "Python", 37, 5, 6, 48
"/home/hhy/Social-Production/test.py", "Python", 35, 2, 12, 49
"/home/hhy/Social-Production/utils.py", "Python", 336, 34, 67, 437
"Total", "-", 3966, 568, 902, 5436